단어	음(읽는 법)
下山	하산
出口	출구
外出	외출
左右	좌우
大小	대소
中心	중심
小門	소문
地上	지상
地名	지명
山水	산수
白日	백일
千年	천년
馬車	마차
魚肉	어육
先生	선생
姓名	성명
靑山	청산
玉石	옥석
水口	수구
白水	백수
三月	삼월
九月	구월
八月	팔월
四人	사인
十人	십인
男子	남자
母子	모자
兄弟	형제
左手	좌수
手足	수족
心中	심중
名山	명산
千人	천인
入山	입산
入口	입구
內外	내외
上下	상하
年中	연중
大門	대문
天地	천지
地下	지하
川水	천수
山川	산천
百年	백년
白馬	백마
牛肉	우육
耳目	이목
出生	출생
生名	생명
林木	림목
木馬	목마
山門	산문
百名	백명
四日	사일
八日	팔일
六月	유월
三人	삼인
一人	일인
女子	여자
父母	부모
弟子	제자
右手	우수
足下	족하
名門	명문
百人	백인
