下山	하산
入山	입산
出口	출구
入口	입구
外出	외출
內外	내외
左右	좌우
上下	상하
大小	대소
手足	수족
年中	연중
山川	산천
山水	산수
靑山	청산
白日	백일
中心	중심
大門	대문
小門	소문
水口	수구
山門	산문
左手	좌수
右手	우수
足下	족하
男子	남자
女子	여자
父母	부모
兄弟	형제
母子	모자
弟子	제자
三月	삼월
四日	사일
九月	구월
八日	팔일
十人	십인
一人	일인
白水	백수
金門	금문
火水	화수
土木	토목
日月	일월
東西	동서
南北	남북
東門	동문
西門	서문
北門	북문
南門	남문
三人	삼인
四人	사인
八月	팔월
六月	유월
