一人	일인
二人	이인
三月	삼월
四日	사일
五兄	오형
六月	유월
七月	칠월
八日	팔일
九月	구월
十人	십인
父母	부모
兄弟	형제
男子	남자
女子	여자
母子	모자
弟子	제자
南北	남북
東西	동서
東門	동문
西門	서문
北門	북문
南門	남문
木門	목문
水門	수문
金門	금문
火水	화수
日月	일월
土木	토목
金水	금수
十月	시월
三人	삼인
四人	사인
八月	팔월
