단어	음(읽는 법)
食事	식사
食堂	식당
今月	금월
今日	금일
今年	금년
王子	왕자
王國	왕국
王位	왕위
正門	정문
正月	정월
主人	주인
主力	주력
工人	공인
工場	공장
工夫	공부
古文	고문
本文	본문
文人	문인
文字	문자
自立	자립
自主	자주
自動	자동
向上	향상
向日	향일
向後	향후
衣食	의식
衣服	의복
衣類	의류
休息	휴식
休學	휴학
同心	동심
同名	동명
同行	동행
世代	세대
世人	세인
少年	소년
少女	소녀
正當	정당
正答	정답
夕食	석식
車道	차도
王室	왕실
向前	향전
向外	향외
字音	자음
字形	자형
