九	구
金	금
南	남
男	남
女	녀
東	동
六	육
母	모
木	목
門	문
父	부
北	북
四	사
三	삼
西	서
水	수
十	십
五	오
月	월
二	이
人	인
日	일
一	일
子	자
弟	제
七	칠
土	토
八	팔
兄	형
火	화
