車	거
巾	건
古	고
工	공
今	금
同	동
力	력
立	립
末	말
文	문
方	방
本	본
夫	부
不	불
士	사
夕	석
世	세
少	소
食	식
央	앙
王	왕
位	위
衣	의
字	자
自	자
正	정
主	주
寸	촌
向	향
休	휴
